11111111111111
1C00C00000C0P1
10011100000001
1C0E1C00000001
11111111111111