11111111111111
1000C0000000P1
10011100000001
100E1C00000001
11111111111111