111111111111111111111111
1000001000C0010000000001
1000001000100100000C0001
100000C000100C0000000001
100011111111111111111101
100C0000E100000000001P01
111111111111111111111111