1111111111111111111111111111111
1000001000C00100000000000C00001
1000001000100100000000000100001
100000C000100C00000000000100001
1000111111111111111111111111001
100C0000E100000000001P000000001
1111111111111111111111111111101