11111111111111111111111
1E0000000C11C0000100001
10000000001100000100001
100000000C11C0000100001
10000000000000111111001
1C0000000011000000000P1
11111111111111111111111