11111111111111
1000C0000C00P1
10011100000001
10CE1C000P0C01
11111111111111