1111111111111111111111111111111
1000000000C00000000000000C00001
10000C00000000C0000000000000001
1000000000000CC0000000000000001
1000111111111111111111111111001
1C000000100000E000001P000000001
1111111111111111111111111111101