111111111111111111111111
1000001000C0010000000001
100000100010010000000001
100000C000100C0000000001
100011111111111111111101
100C000010000E0000001PC1
111111111111111111111111